_ _ _ _ W _ _ _ _ _
_ _ _ _ O _ _ _ _ _
_ _ _ _ R _ _ _ _ _
_ _ _ _ L _ _ _ _ _
_ _ _ _ D _ _ _ _ _
_ _ _ _ _ _ _ _ _ _
_ _ _ _ _ _ _ _ _ _
_ _ H E L L O _ _ _
_ _ _ _ _ _ _ _ _ _
_ _ _ _ _ _ _ _ _ _

